NO  ./sprites/xpm_images/east.xpm
SO  ./sprites/xpm_images/east.xpm
WE  ./sprites/xpm_images/east.xpm
EA  ./sprites/xpm_images/east.xpm

C 255,10,251
F 0,156,29

    11
 111111111111111111        1
1000000001000000001       101  11
1000000000100000001   1  11E111111
1111111101111111111  111  101
1111111101111111111        1
1000100000000000001
10000000000100000011
100010000010100000001
11111111111111111111111111