NO   ./sprites/xpm_images/east.xpm
SO  ./sprites/xpm_images/east.xpm
WE  ./sprites/xpm_images/east.xpm
EA  ./sprites/xpm_images/east.xpm

C 255,141,,114
F 0,156,29

    11   
 
 
 1111111111111111111111
   111000000001000000001             11
111000000010000000111111   1  111111111
1111111101111111111  111
1111111111111111111
100010E000000000001
1000000000010000001
1000100000101000001
11111111111111111111111111