NO   ./sprites/xpm_images/east.xpm
SO  ./sprites/xpm_images/east.xpm
WE  ./sprites/xpm_images/east.xpm
EA  ./sprites/xpm_images/east.xpm

C 0,141,114
F 0,156,29

    11           
 111111111111111111
1000000001000000001             11
1000000000100000001   1  111111111
111111110111111111   111
1111111111111111111
100000E000000000001
1000000000010000001
1000000000101000001
11111111111111111111111111